#Earth
Brabus=CutthroatChannel
HuntersHideout=HiddenGrotto
LastWill=FindMonkeyKey
LizAndLiz=TheWarren
MadMerchant=Junktown
RootBrute=SunkenPassage
RootCultist=MarrowPass
RootDragon=TheAshYard
RootEnt=TheChokingHollow
RootShrine=TheGallows
RootTumbleweed=TheTangledPass
RootWraith=TheHiddenSanctum
Splitter=ResearchStationAlpha

#Rhom
ArmorVault=VaultOfTheHeralds
HoundMaster=TheBurrows
Sentinel=ShackledCanyon
SwarmMaster=TheIronRift
TheCleanRoom=ThePurgeHall
TheHarrow=TheBunker
TheLostGantry=ConcourseOfTheSun
Vyr=TheArdentTemple
WastelandGuardian=LoomOfTheBlackSun

#Corsus
BarbTerror=NeedleLair
BrainBug=StrangePass
Fatty=TheFetidGlade
FetidPool=FetidPools
FlickeringHorror=HallOfWhispers
QueensTemple=IskalTemple
SlimeHulk=TheDrownedTrench
SwampGuardian=The Grotto
Tyrant=TheCapillary
Wisp=CircletHatchery

#Yaesha
BlinkFiend=Widow'sPass
BlinkThief=ForgottenUndercroft
DoeShrine=Widow'sVestry
ImmolatorAndZephyr=WitheringVillage
KinCaller=TheHallOfJudgement
StormCaller=Heretic'sNest
StuckMerchant=MerchantDungeon
TheRisen=Ahanae'sLament
TotemFather=TheScaldingGlade
Wolf=TheScaldingGlade
WolfShrine=Martyr'sSanctuary
